Command Mode (press Esc to enable)                      Edit Mode (press Enter to enable)
Enter: enter edit mode                                  Esc: command mode
							Ctrl-M: command mode

Ctrl-Shift-F: open the command palette			Ctrl-Shift-F: open the command palette
Ctrl-Shift-P: open the command palette                  Ctrl-Shift-P: open the command palette
P: open the command palette
H: show keyboard shortcuts

Ctrl-S: Save and Checkpoint
S: Save and Checkpoint					Ctrl-S: Save and Checkpoint

Shift-Enter: run cell, select below			Shift-Enter: run cell, select below
Ctrl-Enter: run selected cells                          Ctrl-Enter: run selected cells
Alt-Enter: run cell, insert below                       Alt-Enter: run cell, insert below

I,I: interrupt kernel
0,0: restart the kernel (with dialog)

Esc: close the pager
Q: close the pager

F: find and replace

Y: to code
M: to markdown
R: to raw
1: to heading 1
2: to heading 2
3: to heading 3
4: to heading 4
5: to heading 5
6: to heading 6

K: select cell above					
Up: select cell above
Down: select cell below
J: select cell below
Shift-K: extend selected cells above
Shift-Up: extend selected cells above
Shift-Down: extend selected cells below
Shift-J: extend selected cells below

A: insert cell above
B: insert cell below
D,D: delete selected cells
Z: undo cell deletion
Shift-M: merge selected cells, or current cell with cell below if only one cell selected	Ctrl-Shift-Minus: split cell
X: cut selected cells
C: copy selected cells
Shift-V: paste cells above
V: paste cells below

L: toggle line numbers
O: toggle output of selected cells
Shift-O: toggle output scrolling of selected cells
Shift-L: toggles line numbers in all cells, and persist the setting

Shift-Space: scroll notebook up
Space: scroll notebook down

----------

Tab: code completion or indent
Shift-Tab: tooltip
Ctrl-]: indent
Ctrl-[: dedent

Ctrl-A: select all
Ctrl-Z: undo
Ctrl-Shift-Z: redo
Ctrl-Y: redo

Ctrl-Home: go to cell start
Ctrl-Up: go to cell start
Ctrl-End: go to cell end
Ctrl-Down: go to cell end
Ctrl-Left: go one word left
Ctrl-Right: go one word right
Ctrl-Backspace: delete word before
Ctrl-Delete: delete word after

Down: move cursor down
Up: move cursor up

